Z Z Z Z Z Z Z Z Z Z Z Z Z Z Z Z Z Z Z Z Z Z Z Z Z Z
Z Z Z Z Z Z Z Z Z Z Z Z Z Z Z Z Z Z Z Z Z Z Z Z Z Z
Z Z Z Z Z Z Z Z Z Z Z Z Z Z Z Z Z Z Z Z Z Z Z Z Z Z
Z Z Z W W W W W W W W W W W W W W W W W W W W Z Z Z
Z Z Z W O O O O O O H W W W W W W O F F O O W Z Z Z
Z Z Z W W W W O O W W W W W W W W O F F O O W Z Z Z
Z Z Z W O F F E F F O O O O O O O O W W W O W Z Z Z
Z Z Z W W O W O O F F W W W W O O E O F F W W Z Z Z
Z Z Z W O W O O W W W W W W W W W O O F W W W Z Z Z
Z Z Z W O O O W W W W W O O O O O O O O W W W Z Z Z
Z Z Z W W F O W W W W W W W W W O F F O O W W Z Z Z
Z Z Z W O O O W W W W W W W O O O O W W O W W Z Z Z
Z Z Z W O O F F F O O O O O O O W W W W O W W Z Z Z
Z Z Z W W O E O W O W O W O W W W W W W O O W Z Z Z
Z Z Z W W W O O O O F W W W W W W O O O O E W Z Z Z
Z Z Z W W W W O O W W W W W W W W O O O F F W Z Z Z
Z Z Z W O O O O O O O O O E O O O O W W W O W Z Z Z
Z Z Z W W O O O O F O W W W W O O O F O E O W Z Z Z
Z Z Z W W W O O W W W W W W W W W O O O W O W Z Z Z
Z Z Z W W O O W W W W W O O O O O O F F W O W Z Z Z
Z Z Z W W E O W W W W W W W W W F O F F O O W Z Z Z
Z Z Z W O F F W W W W W W W F E O O W W W T W Z Z Z
Z Z Z W W W W W W W W W W W W W W W W W W 1 W Z Z Z
Z Z Z W W W W W W W W W W W W W W W W W W W W Z Z Z
Z Z Z Z Z Z Z Z Z Z Z Z Z Z Z Z Z Z Z Z Z Z Z Z Z Z
Z Z Z Z Z Z Z Z Z Z Z Z Z Z Z Z Z Z Z Z Z Z Z Z Z Z
Z Z Z Z Z Z Z Z Z Z Z Z Z Z Z Z Z Z Z Z Z Z Z Z Z Z