Z Z Z Z Z Z Z Z Z Z Z Z Z Z Z Z Z Z Z Z Z Z Z Z Z Z
Z Z Z Z Z Z Z Z Z Z Z Z Z Z Z Z Z Z Z Z Z Z Z Z Z Z
Z Z Z Z Z Z Z Z Z Z Z Z Z Z Z Z Z Z Z Z Z Z Z Z Z Z
Z Z Z F F F F F F F F F F F F F F F F F F F F Z Z Z
Z Z Z F O O O O O O H F F F F F F O F F O O F Z Z Z
Z Z Z F F F F O O F F F F F F F F O F F O O F Z Z Z
Z Z Z F O F F E F F O O O O O O O O F F F O F Z Z Z
Z Z Z F F O F O O F F F F F F O O E O F F F F Z Z Z
Z Z Z F O F O O F F F F F F F F F O O F F F F Z Z Z
Z Z Z F O O O F F F F F O O O O O O O O F F F Z Z Z
Z Z Z F F F O F F F F F F F F F O F F O O F F Z Z Z
Z Z Z F O O O F F F F F F F O O O O F F O F F Z Z Z
Z Z Z F O O F F F O O O O O O O F F F F O F F Z Z Z
Z Z Z F F O E O F O F O F O F F F F F F O O F Z Z Z
Z Z Z F F F O O O O F F F F F F F O O O O E F Z Z Z
Z Z Z F F F F O O F F F F F F F F O O O F F F Z Z Z
Z Z Z F O O O O O O O O O E O O O O F F F O F Z Z Z
Z Z Z F F O O O O F O F F F F O O O F O E O F Z Z Z
Z Z Z F F F O O F F F F F F F F F O O O F O F Z Z Z
Z Z Z F F O O F F F F F O O O O O O F F F O F Z Z Z
Z Z Z F F E O F F F F F F F F F F O F F O O F Z Z Z
Z Z Z F O F F F F F F F F F F E O O F F F T F Z Z Z
Z Z Z F F F F F F F F F F F F F F F F F F 1 F Z Z Z
Z Z Z F F F F F F F F F F F F F F F F F F F F Z Z Z
Z Z Z Z Z Z Z Z Z Z Z Z Z Z Z Z Z Z Z Z Z Z Z Z Z Z
Z Z Z Z Z Z Z Z Z Z Z Z Z Z Z Z Z Z Z Z Z Z Z Z Z Z
Z Z Z Z Z Z Z Z Z Z Z Z Z Z Z Z Z Z Z Z Z Z Z Z Z Z
