Z Z Z Z Z Z Z Z Z Z Z Z Z Z Z Z Z Z Z Z Z Z Z Z Z Z
Z Z Z Z Z Z Z Z Z Z Z Z Z Z Z Z Z Z Z Z Z Z Z Z Z Z
Z Z Z Z Z Z Z Z Z Z Z Z Z Z Z Z Z Z Z Z Z Z Z Z Z Z
Z Z Z W W W W W W W W W W W W W W W W W W W W Z Z Z
Z Z Z W W W W W W W W O f O W W W W W W W W W Z Z Z
Z Z Z W W W W W W W W O O E W W W W W W W W W Z Z Z
Z Z Z W W W W W W W W W O O W W W W W W W W W Z Z Z
Z Z Z W W W W W W W W W 6 W W W W W W W W W W Z Z Z
Z Z Z W W W W W W W W O O O W W W W W W W W W Z Z Z
Z Z Z W W W W W W W W W I W W W W W W W W W W Z Z Z
Z Z Z W W W W W W W W W I W W W W W W W W W W Z Z Z
Z Z Z W O E O W O W W O O O W W O W W O O O W Z Z Z
Z Z Z W O r O 3 O I I O O O I I O 4 O O s E W Z Z Z
Z Z Z W O O O W O W W H y O W W O W W O O O W Z Z Z
Z Z Z W W W W W W W W W 5 W W W W W W W W W W Z Z Z
Z Z Z W W W W W W W W W O W W W W W W W W W W Z Z Z
Z Z Z W W W W B t O O W O W W W W O O t b W W Z Z Z
Z Z Z W 1 W W W W W O W O W W W W O W W W W W Z Z Z
Z Z Z W T W W B O O O O O W W W W O O t b W W Z Z Z
Z Z Z W F W W W W W O W W W W W W O W W W W W Z Z Z
Z Z Z W A W W B t O O O O O O O O O O O b W W Z Z Z
Z Z Z W O W W W W W O W W W W W W W W W W W W Z Z Z
Z Z Z W O O O O O O O O O O O A F E t T 1 W W Z Z Z
Z Z Z W W W W W W W W W W W W W W W W W W W W Z Z Z
Z Z Z Z Z Z Z Z Z Z Z Z Z Z Z Z Z Z Z Z Z Z Z Z Z Z
Z Z Z Z Z Z Z Z Z Z Z Z Z Z Z Z Z Z Z Z Z Z Z Z Z Z
Z Z Z Z Z Z Z Z Z Z Z Z Z Z Z Z Z Z Z Z Z Z Z Z Z Z