Z Z Z Z Z Z Z Z Z Z Z Z Z Z Z Z Z Z Z Z Z Z Z Z Z Z
Z Z Z Z Z Z Z Z Z Z Z Z Z Z Z Z Z Z Z Z Z Z Z Z Z Z
Z Z Z Z Z Z Z Z Z Z Z Z Z Z Z Z Z Z Z Z Z Z Z Z Z Z
Z Z Z F F F F F F F F F F F F F F F F F F F F Z Z Z
Z Z Z F F F F F F F F t f t F F F F F F F F F Z Z Z
Z Z Z F F F F F F F F t O E F F F F F F F F F Z Z Z
Z Z Z F F F F F F F F F O t F F F F F F F F F Z Z Z
Z Z Z F F F F F F F F F 6 F F F F F F F F F F Z Z Z
Z Z Z F F F F F F F F O O O F F F F F F F F F Z Z Z
Z Z Z F F F F F F F F F I F F F F F F F F F F Z Z Z
Z Z Z F F F F F F F F F I F F F F F F F F F F Z Z Z
Z Z Z F O E O F O F F O O O F F O F F A A A F Z Z Z
Z Z Z F F r O 3 O I I O O O I I O 4 O O s E F Z Z Z
Z Z Z F O O O F O F F H y O F F O F F A A A F Z Z Z
Z Z Z F F F F F F F F F 5 F F F F F F F F F F Z Z Z
Z Z Z F F F F F F F F F O F F F F F F F F F F Z Z Z
Z Z Z F F F F B t O O F O F F F F O O t b F F Z Z Z
Z Z Z F 1 F F F F F O F O F F F F O F F F F F Z Z Z
Z Z Z F T F F B O O O O O F F F F O O t b F F Z Z Z
Z Z Z F F F F F F F O F F F F F F O F F F F F Z Z Z
Z Z Z F A F F B t O O O O O O O O O O O b F F Z Z Z
Z Z Z F O F F F F F O F F F F F F F F F F F F Z Z Z
Z Z Z F O O O O O O O O O O O A F E t T 1 F F Z Z Z
Z Z Z F F F F F F F F F F F F F F F F F F F F Z Z Z
Z Z Z Z Z Z Z Z Z Z Z Z Z Z Z Z Z Z Z Z Z Z Z Z Z Z
Z Z Z Z Z Z Z Z Z Z Z Z Z Z Z Z Z Z Z Z Z Z Z Z Z Z
Z Z Z Z Z Z Z Z Z Z Z Z Z Z Z Z Z Z Z Z Z Z Z Z Z Z
